[main]
encoding = utf-8
version = 1.0.0
serverAddress = http://www.zoo-project.org/zoo/
language = en-US
lang = fr-FR,en-CA,en-US
tmpPath=/tmp/
tmpUrl = ../tmpPathRelativeToServerAdress/
dataPath = @sharedstatedir@/zoo-project
cacheDir = /tmp/

[identification]
title = The ZOO-Project OGC WPS Development Server
abstract = Development version of ZOO-Project OGC WPS. See http://www.zoo-project.org
fees = None
accessConstraints = none
keywords = WPS,GIS,buffer

[provider]
providerName=ZOO-Project
providerSite=http://www.zoo-project.org
individualName=Gerald FENOY
positionName=Developer
role=Dev
addressDeliveryPoint=1280, avenue des Platanes
addressCity=Lattes
addressAdministrativeArea=False
addressPostalCode=34970
addressCountry=fr
addressElectronicMailAddress=gerald.fenoy@geolabs.fr
phoneVoice=False
phoneFacsimile=False

